include::../../../dir/inc/DefPractice.adoc[]

==  [.black]#Learn#

=== [.black]#Main Points: The Business Model Canvas#

image::humanistic/bmcanvas.jpg[alt="BusinessModelCanvas",align="center"]

[horizontal]
Key Activites::          The most important things a company must do to make its business model work
Key Partners::           The network of suppliers and partners that make the business model work
Key Resources::          The most important assets required to make a business model work
Value Proposition::      The bundle of products and services that create value for a specific Customer Segment
Customer Relationships:: The types of relationships a company establishes with specific Customer Segments
Customers::              The different groups of people or organizations an enterprise aims to reach and serve
Channels::               How acompany communicates with and reaches itsCustomer Segments to deliver a Value Proposition
Costs::                  Describes all costs incurred to operate a business model
Revenue::                Represents the cash a company generates from each Customer Segment

<<<
=== [.black]#Practices#

image::onto/Learn.png[alt="Learn",align="center"]

<<<
=== [.black]#What Makes Learn Work#

=== [.black]#Summary#

==== [.black]#Collaborate#
[horizontal]
Partner::  The business network of partners and suppliers.
Activity:: The current teams tasks generated by requests.
Kanban::   Priorized activities: To Do, In Progress and Closed.
Team::     Members and their roles.

==== [.black]#Product#
[horizontal]
Proposition::  The proposed ideas for new products.
Entitlement::  The secure UI allocation of Resources* to teams by roles.
Portfolio::    The entire suite of products that a company will offer.
Intelligence:: Data with business descriptions.

==== [.black]#Discover#
[horizontal]
Vision::     The shared vision conveyed to customers.
Community::  Who the enterprise aims to reach and serve.
Channel::    Communicatuon and delivery mechanisms.
Assumption:: Documenting guess for quanitative validation.

